1111111111111111111
1000000000X00000001
100C000000000000001
1C0P0E0000000CC0001
1000000000110000C01
1000C0000000X0000C1
1111111111111111111