11111111111111111111111111
1P00000000000000X000000C01
11111111111110011111111111
10C00000000X0000X000000C01
11111111111110011111111111
10C00000000X0000X000000C01
11111111111110011111111111
10C00000000X0000X000000C01
11111111111110011111111111
10C00000000X0000X000000C01
11111111111110011111111111
10C00000000X0000X000000C01
11111111111110011111111111
10C00000000X0000X0000000E1
11111111111111111111111111