1111111111111111111
1000000000000000001
100C000000000000001
1C0P0E0000000CC0001
1000000000110000C01
1000C000000000000C1
1111111111111111111