1111111111
1000000001
100C000001
1C0P0E0001
1000000C01
1000C00001
1111111111