1111111
1P00001
100C001
1C000E1
1111111